memcpy.o	libc.a	
DALModEnv.o	DALSys.lib	core/dal/framework/sys
a2_dl_per.o	utils_a2_driver.lib	utils/a2/driver
a2_hdlc.o	utils_a2_driver.lib	utils/a2/driver
a2_ipfilter.o	utils_a2_driver.lib	utils/a2/driver
a2_sio.o	utils_a2_driver.lib	utils/a2/driver
a2_ul_per.o	utils_a2_driver.lib	utils/a2/driver
appmgr.o	appmgr.lib	mcs/appmgr
bit.o		core/services/utils
cb_utils.o	nas_cb.lib	nas/cb
cfa_msm.o	nas_services.lib	nas/services
cm.o	mmode_cm.lib	mmode/cm
cmcall.o	mmode_cm.lib	mmode/cm
cmclient.o	mmode_cm.lib	mmode/cm
cmipapp.o	mmode_cm.lib	mmode/cm
cmph.o	mmode_cm.lib	mmode/cm
cmutil.o	mmode_cm.lib	mmode/cm
cnm_mntask_main.o	nas_cnm.lib	nas/cnm
comptask.o	comptask.lib	datamodem/3gpp/comptask
crc.o		core/services/utils
db.o	cp.lib	1x/cp
delaop.o	libstdc++.a	
delop.o	libstdc++.a	
diagpkt.o	diag.lib	core/services/diag
dog.o	dog.lib	core/debugtools/dog
ds707_ccm.o	data_1x_707_mdm.lib	datamodem/3gpp2/ds707
ds707_extif.o	data_1x_707.lib	datamodem/3gpp2/ds707
ds707_scrm.o	data_1x_707.lib	datamodem/3gpp2/ds707
ds_3gpp_api.o	ps.lib	datamodem/3gpp/ps
ds_3gpp_hdlr.o	ps.lib	datamodem/3gpp/ps
ds_qmi_cflog.o	qmidata.lib	datamodem/interface/qmidata
ds_qmi_svc.o	qmicore.lib	datamodem/interface/qmicore
dsatutil.o	atcop.lib	datamodem/interface/atcop
dsdvrlp_rx.o	1xrlp.lib	datamodem/3gpp2/1xrlp
dsgcsdl1if.o	umtscs.lib	datamodem/3gpp/csd
dshdr_an_mgr.o	data_hdr.lib	datamodem/3gpp2/hdrdata
dsm.o	mcs_dsm.lib	core/memory/dsm
dsm_pool.o	mcs_dsm.lib	core/memory/dsm
dsm_queue.o	mcs_dsm.lib	core/memory/dsm
dsmbit.o	mcs_dsm.lib	core/memory/dsm
dsmutil.o	mcs_dsm.lib	core/memory/dsm
dsrlp.o	1xrlp.lib	datamodem/3gpp2/1xrlp
dsrlp_stats.o	1xrlp.lib	datamodem/3gpp2/1xrlp
enc.o	drivers.lib	1x/drivers
err.o	err.lib	core/debugtools/err
err_nv_log.o	err.lib	core/debugtools/err
event_api.o	diag.lib	core/services/diag
fc.o	fc.lib	utils/fc
fclose.o	libc.a	
floor.o	libc.a	
fopen.o	libc.a	
ftm.o	rf_common_ftm.lib	rfa/rf/common/ftm
ftm_egprs_ber.o	rf_gsm_ftm.lib	rfa/rf/gsm/ftm
ftm_gsm_ber.o	rf_gsm_ftm.lib	rfa/rf/gsm/ftm
fwrite.o	libc.a	
fws_app.o	fws.lib	mcs/fws
fws_ipc.o	fws.lib	mcs/fws
fws_smem.o	fws.lib	mcs/fws
geran_test_mode_api.o	GERAN_GL1.lib	geran/gl1
gl1_hw.o	GERAN_GDRIVERS.lib	geran/gdrivers
gl1_hw_cm.o	GERAN_GDRIVERS.lib	geran/gdrivers
gl1_hw_dtm.o	GERAN_GDRIVERS.lib	geran/gdrivers
gl1_hw_gprs.o	GERAN_GDRIVERS.lib	geran/gdrivers
gl1_hw_gsm.o	GERAN_GDRIVERS.lib	geran/gdrivers
gl1_hw_sched.o	GERAN_GDRIVERS.lib	geran/gdrivers
gl1_msg_tch.o	GERAN_GDRIVERS.lib	geran/gdrivers
gmmutils.o	nas_mm.lib	nas/mm
gnss_api_stub.o	gps_pvt.lib	gps
grlcqmi.o	GERAN_GRLC.lib	geran/grlc
gsclassmark.o	nas_services.lib	nas/services
gsmsg.o	nas_services.lib	nas/services
gsndcp.o	GERAN_GSNDCP.lib	geran/gsndcp
gsnvif.o	nas_services.lib	nas/services
gsvoiceif.o	nas_services.lib	nas/services
gtmrs.o	GERAN_GDRIVERS.lib	geran/gdrivers
hdralmp.o	cp.lib	hdr/cp
hdrcom_api.o	common.lib	hdr/common
hdrcp_api.o	common.lib	hdr/common
hdrds.o	data_hdr.lib	datamodem/3gpp2/hdrdata
hdrl1_api.o	common.lib	hdr/common
hdrmrlp.o	hdrmrlp.lib	datamodem/3gpp2/hdrdata
hdrmrlpresv.o	hdrmrlp.lib	datamodem/3gpp2/hdrdata
hdrmrlpspd.o	hdrmrlp.lib	datamodem/3gpp2/hdrdata
hdrovhd.o	cp.lib	hdr/cp
hdrpac.o	data_hdr.lib	datamodem/3gpp2/hdrdata
hdrpac_mdm.o	data_hdr_mdm.lib	datamodem/3gpp2/hdrdata
hdrpacdsif.o	data_hdr.lib	datamodem/3gpp2/hdrdata
hdrrlp.o	data_hdr_mdm.lib	datamodem/3gpp2/hdrdata
hdrrlpdnak.o	hdrmrlp.lib	datamodem/3gpp2/hdrdata
hdrrlplog.o	hdrmrlp.lib	datamodem/3gpp2/hdrdata
hdrrlpnak.o	data_hdr_mdm.lib	datamodem/3gpp2/hdrdata
hdrrlptxq.o	data_hdr_mdm.lib	datamodem/3gpp2/hdrdata
hdrsap.o	cp.lib	hdr/cp
intconv.o		core/services/utils
l1_log.o	GERAN_GL1.lib	geran/gl1
l1_utils.o	GERAN_GL1.lib	geran/gl1
l1utils.o	lib_wcdma_l1_offline.lib	wcdma/l1/offline
l2dltask.o	l2.lib	wcdma/l2
list.o		core/services/utils
log_api.o	diag.lib	core/services/diag
mc.o	cp.lib	1x/cp
mccap.o	cp.lib	1x/cp
mccds.o	cp.lib	1x/cp
mccsch.o	cp.lib	1x/cp
mccsrid.o	cp.lib	1x/cp
mccsup.o	cp.lib	1x/cp
mccsyobj.o	cp.lib	1x/cp
mcpm.o	mpower_mcpm.lib	mpower/mcpm
mcpm_drv.o	mpower_mcpm.lib	mpower/mcpm
mcpm_npa.o	mpower_mcpm.lib	mpower/mcpm
mcs_sups.o	supstr.lib	mcs/supstr
mcs_timer.o	mcs_timers.lib	mcs/mcs_timers
md5c.o		core/services/utils
mdrrlp.o	1xrlp.lib	datamodem/3gpp2/1xrlp
mdsp_intf.o	GERAN_GMDSP.lib	geran/gmdsp6
mdspsync.o	lib_wcdma_l1_offline.lib	wcdma/l1/offline
memcmp.o	libc.a	
memheap.o		core/services/utils
memmove.o	libc.a	
mmoc.o	mmode_mmoc.lib	mmode/mmoc
mmsim.o	nas_mm.lib	nas/mm
mmtask.o	nas_mm.lib	nas/mm
mmumts.o	nas_mm.lib	nas/mm
mnutils.o	nas_mn.lib	nas/mn
modem_mem.o	mem.lib	mcs/mem
msg_api.o	diag.lib	core/services/diag
msgr.o	msgr.lib	mcs/msgr
mutils_circ_q.o	utils_common.lib	utils/common
mvs.o	mvs.lib	multimedia/audio/voice/common/mvs
newaop.o	libstdc++.a	
newop.o	libstdc++.a	
nvim.o	nvim.lib	core/services/nv
pbmlib.o	pbm.lib	pbm
pbmlibutils.o	pbm.lib	pbm
pd_ConsInt8.o	utils_osys_rtpersrc.lib	utils/osys/rtpersrc
pd_ConsUInt8.o	utils_osys_rtpersrc.lib	utils/osys/rtpersrc
pd_ConsUnsigned.o	utils_osys_rtpersrc.lib	utils/osys/rtpersrc
pd_OctetString.o	utils_osys_rtpersrc.lib	utils/osys/rtpersrc
pd_common.o	utils_osys_rtpersrc.lib	utils/osys/rtpersrc
pow.o	libc.a	
printf.o	libc.a	
prl.o	mmode_sd.lib	mmode/sd
ps_iphc.o	lib_hc.lib	datamodem/protocols/hc
ps_slhc.o	hc.lib	datamodem/protocols/hc
pthread.o	libposix.a	
pu_common.o	utils_osys_rtpersrc.lib	utils/osys/rtpersrc
puts.o	libc.a	
qdsp_dfdiv_opt.o	libqcc.a	
qdsp_divdi3.o	libqcc.a	
qdsp_divsi3.o	libqcc.a	
qdsp_modsi3.o	libqcc.a	
qdsp_sfdiv_opt.o	libqcc.a	
qdsp_udivdi3.o	libqcc.a	
qdsp_udivsi3.o	libqcc.a	
qdsp_umoddi3.o	libqcc.a	
qdsp_umodsi3.o	libqcc.a	
qmi_csi_common.o	qcsi.lib	core/mproc/qmi
qmi_framework.o	qmicore.lib	datamodem/interface/qmicore
qsort.o	libc.a	
qualcomm_mobile_access_point_v01.o	interfaces_qmi_qcmap.lib	api/qcmap
queue.o		core/services/utils
qurt_futex_c.o	libqurt.a	
qurt_sem.o	libqurt.a	
qw.o		core/services/utils
rabmtask.o	nas_rabm.lib	nas/rabm
ran.o		core/services/utils
rand.o	libc.a	
rcevt.o	rcevt.lib	core/debugtools/rcevt
rcinit.o	rcinit.lib	core/debugtools/rcinit
rdevmap.o	rdevmap_apps.lib	core/wiredconnectivity/rdevmap
reg_sim.o	nas_reg.lib	nas/reg
rex_qube.o	rexl4_qdsp6.lib	core/kernel/rexemu
rextime.o	rexl4_qdsp6.lib	core/kernel/rexemu
rf_test_task.o	rf_common_ftm.lib	rfa/rf/common/ftm
rfm.o	rf_common_rf_mc.lib	rfa/rf/common/rf/mc
rfm_1x.o	rf_cdma_1x_rf.lib	rfa/rf/cdma/1x/rf
rfm_common_sar.o	rf_common_rf_mc.lib	rfa/rf/common/rf/mc
rfm_gsm.o	rf_gsm_rf_mc.lib	rfa/rf/gsm/rf/mc
rfm_hdr.o	rf_cdma_hdr_rf.lib	rfa/rf/cdma/hdr/rf
rfm_meas.o	rf_meas_rf_mc.lib	rfa/rf/meas/rf/mc
rfm_resources.o	rf_common_rf_mc.lib	rfa/rf/common/rf/mc
rfwcdma_core.o	rf_wcdma_rf_core.lib	rfa/rf/wcdma/rf/core
rlcdl.o	rlc.lib	wcdma/rlc
rlcul.o	rlc.lib	wcdma/rlc
rlgc.o	mux.lib	1x/mux
rlp.o	1xrlp.lib	datamodem/3gpp2/1xrlp
rr_dtm.o	GERAN_GRR.lib	geran/grr
rr_rrc_if.o	GERAN_GRR.lib	geran/grr
rrccmd.o	rrc.lib	wcdma/rrc
rrcdata.o	rrc.lib	wcdma/rrc
rrciho.o	rrc.lib	wcdma/rrc
rrcllcoc.o	rrc.lib	wcdma/rrc
rtxBitDecode.o	utils_osys_rtxsrc.lib	utils/osys/rtxsrc
rtxError.o	utils_osys_rtxsrc.lib	utils/osys/rtxsrc
rtxMemFuncs.o	utils_osys_rtxsrc.lib	utils/osys/rtxsrc
rtxMemHeapAlloc.o	utils_osys_rtxsrc.lib	utils/osys/rtxsrc
rtxMemHeapFree.o	utils_osys_rtxsrc.lib	utils/osys/rtxsrc
rxctraffic.o	mux.lib	1x/mux
rxlm_intf.o	lm_common.lib	rfa/lm/common
semaphore.o	libposix.a	
sio.o	sio.lib	core/wiredconnectivity/sio
snm.o	cp.lib	1x/cp
snprintf.o	libc.a	
sqrt.o	libc.a	
sscanf.o	libc.a	
stm2.o	mcs_stm2.lib	mcs/stm2
strcasecmp.o	libstd.lib	core/kernel/libstd
strchr.o	libc.a	
strlcat.o	libstd.lib	core/kernel/libstd
strlcpy.o	libstd.lib	core/kernel/libstd
strlen.o	libc.a	
strncasecmp.o	libstd.lib	core/kernel/libstd
strncmp.o	libc.a	
strstr.o	libc.a	
strtol.o	libc.a	
sys.o	mmode_cm.lib	mmode/cm
sys_eplmn_list.o	nas_services.lib	nas/services
sys_m.o	sys_m.lib	core/debugtools/sys_m
tctask.o	nas_tc.lib	nas/tc
tcxomgr_cal.o	tcxomgr.lib	mcs/tcxomgr
tcxomgr_ctl.o	tcxomgr_ctrl.lib	mcs/tcxomgr
tcxomgr_data.o	tcxomgr_ctrl.lib	mcs/tcxomgr
time.o	time_qdsp6.lib	core/services/time
time_jul.o	time_qdsp6.lib	core/services/time
timer.o	time_qdsp6.lib	core/services/time
timetickLegacy.o	DALTimetick_modem.lib	core/systemdrivers/timetick
trm.o	trm.lib	mcs/trm
txctraffic.o	mux.lib	1x/mux
txlm_intf.o	lm_common.lib	rfa/lm/common
vsnprint.o	libc.a	
wl1m.o	lib_wcdma_l1_offline.lib	wcdma/l1/offline
wms.o	wms.lib	wms
wsrch.o	lib_wcdma_l1_offline.lib	wcdma/l1/offline
xlog.o	libc.a	
xo_core_api.o	pmic_drivers_xo_v6_protected.lib	rfa/pmic/drivers/xo/xo_v6
xregister.o	libc.a	
xstoul.o	libc.a	
xtouptab.o	libc.a	
